,season,week,awayteam,hometeam,awayscore,homescore,score_abs,winner_home,winner_away
0,2018,2,Ravens,Bengals,23,34,11,1,0
1,2018,2,Panthers,Falcons,24,31,7,1,0
2,2018,2,Chargers,Bills,31,20,-11,0,1
3,2018,2,Texans,Titans,17,20,3,1,0
4,2017,2,Texans,Bengals,13,9,-4,0,1
5,2017,1,Chiefs,Patriots,42,27,-15,0,1
6,2019,1,Packers,Bears,10,3,-7,0,1
7,2018,2,Browns,Saints,18,21,3,1,0
8,2018,2,Dolphins,Jets,20,12,-8,0,1
9,2018,2,Chiefs,Steelers,42,37,-5,0,1
10,2018,1,Falcons,Eagles,12,18,6,1,0
11,2017,2,Cardinals,Colts,16,13,-3,0,1
12,2017,2,Eagles,Chiefs,20,27,7,1,0
13,2017,2,Patriots,Saints,36,20,-16,0,1
14,2017,1,Jets,Bills,12,21,9,1,0
15,2017,1,Falcons,Bears,23,17,-6,0,1
16,2017,1,Ravens,Bengals,20,0,-20,0,1
17,2019,1,Titans,Browns,43,13,-30,0,1
18,2019,1,Ravens,Dolphins,59,10,-49,0,1
19,2019,1,Falcons,Vikings,12,28,16,1,0
20,2019,2,Buccaneers,Panthers,20,14,-6,0,1
21,2018,2,Eagles,Buccaneers,21,27,6,1,0
22,2018,2,Colts,Washington,21,9,-12,0,1
23,2018,2,Cardinals,Rams,0,34,34,1,0
24,2020,1,Texans,Chiefs,20,34,14,1,0
25,2018,1,Bengals,Colts,34,23,-11,0,1
26,2018,1,Titans,Dolphins,20,27,7,1,0
27,2017,2,Vikings,Steelers,9,26,17,1,0
28,2017,2,Bears,Buccaneers,7,29,22,1,0
29,2017,2,Bills,Panthers,3,9,6,1,0
30,2017,1,Steelers,Browns,21,18,-3,0,1
31,2017,1,Cardinals,Lions,23,35,12,1,0
32,2017,1,Raiders,Titans,26,16,-10,0,1
33,2019,1,Bills,Jets,17,16,-1,0,1
34,2019,1,Washington,Eagles,27,32,5,1,0
35,2019,1,Rams,Panthers,30,27,-3,0,1
36,2019,2,49ers,Bengals,41,17,-24,0,1
37,2019,2,Chargers,Lions,10,13,3,1,0
38,2019,2,Vikings,Packers,16,21,5,1,0
39,2018,2,Lions,49ers,27,30,3,1,0
40,2018,2,Raiders,Broncos,19,20,1,1,0
41,2018,2,Patriots,Jaguars,20,31,11,1,0
42,2020,1,Seahawks,Falcons,38,25,-13,0,1
43,2020,1,Jets,Bills,17,27,10,1,0
44,2020,1,Bears,Lions,27,23,-4,0,1
45,2018,1,49ers,Vikings,16,24,8,1,0
46,2018,1,Texans,Patriots,20,27,7,1,0
47,2018,1,Buccaneers,Saints,48,40,-8,0,1
48,2017,2,Titans,Jaguars,37,16,-21,0,1
49,2017,2,Browns,Ravens,10,24,14,1,0
50,2017,2,Jets,Raiders,20,45,25,1,0
51,2021,1,Cowboys,Buccaneers,29,31,2,1,0
52,2017,1,Eagles,Washington,30,17,-13,0,1
53,2017,1,Jaguars,Texans,29,7,-22,0,1
54,2017,1,Colts,Rams,9,46,37,1,0
55,2017,1,Seahawks,Packers,9,17,8,1,0
56,2019,1,Chiefs,Jaguars,40,26,-14,0,1
57,2019,1,Colts,Chargers,24,30,6,1,0
58,2019,1,Bengals,Seahawks,20,21,1,1,0
59,2019,2,Colts,Titans,19,17,-2,0,1
60,2019,2,Patriots,Dolphins,43,0,-43,0,1
61,2019,2,Bills,Giants,28,14,-14,0,1
62,2018,2,Giants,Cowboys,13,20,7,1,0
63,2018,2,Seahawks,Bears,17,24,7,1,0
64,2020,1,Packers,Vikings,43,34,-9,0,1
65,2020,1,Dolphins,Patriots,11,21,10,1,0
66,2020,1,Eagles,Washington,17,27,10,1,0
67,2018,1,Jaguars,Giants,20,15,-5,0,1
68,2018,1,Bills,Ravens,3,47,44,1,0
69,2018,1,Chiefs,Chargers,38,28,-10,0,1
70,2017,2,Dolphins,Chargers,19,17,-2,0,1
71,2017,2,Cowboys,Broncos,17,42,25,1,0
72,2017,2,Washington,Rams,27,20,-7,0,1
73,2021,1,Eagles,Falcons,32,6,-26,0,1
74,2021,1,Steelers,Bills,23,16,-7,0,1
75,2021,1,Vikings,Bengals,24,27,3,1,0
76,2017,1,Panthers,49ers,23,3,-20,0,1
77,2017,1,Giants,Cowboys,3,19,16,1,0
78,2019,1,Giants,Cowboys,17,35,18,1,0
79,2019,1,49ers,Buccaneers,31,17,-14,0,1
80,2019,2,Seahawks,Steelers,28,26,-2,0,1
81,2019,2,Cowboys,Washington,31,21,-10,0,1
82,2019,2,Cardinals,Ravens,17,23,6,1,0
83,2020,1,Raiders,Panthers,34,30,-4,0,1
84,2020,1,Colts,Jaguars,20,27,7,1,0
85,2020,1,Browns,Ravens,6,38,32,1,0
86,2018,1,Seahawks,Broncos,24,27,3,1,0
87,2018,1,Washington,Cardinals,24,6,-18,0,1
88,2018,1,Cowboys,Panthers,8,16,8,1,0
89,2017,2,49ers,Seahawks,9,12,3,1,0
90,2017,2,Packers,Falcons,23,34,11,1,0
91,2017,2,Lions,Giants,24,10,-14,0,1
92,2021,1,49ers,Lions,41,33,-8,0,1
93,2021,1,Cardinals,Titans,38,13,-25,0,1
94,2021,1,Seahawks,Colts,28,16,-12,0,1
95,2019,1,Steelers,Patriots,3,33,30,1,0
96,2019,1,Texans,Saints,28,30,2,1,0
97,2019,1,Broncos,Raiders,16,24,8,1,0
98,2019,2,Jaguars,Texans,12,13,1,1,0
99,2019,2,Chiefs,Raiders,28,10,-18,0,1
100,2019,2,Bears,Broncos,16,14,-2,0,1
101,2020,1,Chargers,Bengals,16,13,-3,0,1
102,2020,1,Buccaneers,Saints,23,34,11,1,0
103,2020,1,Cardinals,49ers,24,20,-4,0,1
104,2018,1,Bears,Packers,23,24,1,1,0
105,2018,1,Jets,Lions,48,17,-31,0,1
106,2018,1,Rams,Raiders,33,13,-20,0,1
107,2021,1,Chargers,Washington,20,16,-4,0,1
108,2021,1,Jets,Panthers,14,19,5,1,0
109,2021,1,Jaguars,Texans,21,37,16,1,0
110,2019,2,Saints,Rams,9,27,18,1,0
111,2019,2,Eagles,Falcons,20,24,4,1,0
112,2019,2,Browns,Jets,23,3,-20,0,1
113,2020,1,Cowboys,Rams,17,20,3,1,0
114,2020,1,Steelers,Giants,26,16,-10,0,1
115,2020,1,Titans,Broncos,16,14,-2,0,1
116,2021,1,Browns,Chiefs,29,33,4,1,0
117,2021,1,Dolphins,Patriots,17,16,-1,0,1
118,2021,1,Packers,Saints,3,38,35,1,0
119,2021,1,Broncos,Giants,27,13,-14,0,1
120,2021,1,Bears,Rams,14,34,20,1,0
121,2021,1,Ravens,Raiders,27,33,6,1,0
122,2017,3,Rams,49ers,41,39,-2,0,1
123,2017,3,Ravens,Jaguars,7,44,37,1,0
124,2017,3,Broncos,Bills,16,26,10,1,0
125,2017,3,Steelers,Bears,17,23,6,1,0
126,2017,3,Falcons,Lions,30,26,-4,0,1
127,2017,3,Browns,Colts,28,31,3,1,0
128,2017,3,Buccaneers,Vikings,17,34,17,1,0
129,2017,3,Texans,Patriots,33,36,3,1,0
130,2017,3,Dolphins,Jets,6,20,14,1,0
131,2017,3,Giants,Eagles,24,27,3,1,0
132,2017,3,Saints,Panthers,34,13,-21,0,1
133,2017,3,Seahawks,Titans,27,33,6,1,0
134,2017,3,Bengals,Packers,24,27,3,1,0
135,2017,3,Chiefs,Chargers,24,10,-14,0,1
136,2017,3,Raiders,Washington,10,27,17,1,0
137,2017,3,Cowboys,Cardinals,28,17,-11,0,1
138,2021,3,Panthers,Texans,24,9,-15,0,1
139,2021,3,Washington,Bills,21,43,22,1,0
140,2021,3,Bears,Browns,6,26,20,1,0
141,2021,3,Ravens,Lions,19,17,-2,0,1
142,2020,2,Bengals,Browns,30,35,5,1,0
143,2020,3,Dolphins,Jaguars,31,13,-18,0,1
144,2021,3,Colts,Titans,16,25,9,1,0
145,2021,3,Chargers,Chiefs,30,24,-6,0,1
146,2021,3,Saints,Patriots,28,13,-15,0,1
147,2021,3,Falcons,Giants,17,14,-3,0,1
148,2020,2,Giants,Bears,13,17,4,1,0
149,2020,2,Falcons,Cowboys,39,40,1,1,0
150,2020,2,Lions,Packers,21,42,21,1,0
151,2019,3,Titans,Jaguars,7,20,13,1,0
152,2020,3,Bears,Falcons,30,26,-4,0,1
153,2020,3,Rams,Bills,32,35,3,1,0
154,2020,3,Washington,Browns,20,34,14,1,0
155,2021,3,Bengals,Steelers,24,10,-14,0,1
156,2021,3,Cardinals,Jaguars,31,19,-12,0,1
157,2021,3,Jets,Broncos,0,26,26,1,0
158,2018,3,Jets,Browns,17,21,4,1,0
159,2021,2,Giants,Washington,29,30,1,1,0
160,2020,2,Jaguars,Titans,30,33,3,1,0
161,2020,2,Vikings,Colts,11,28,17,1,0
162,2020,2,Bills,Dolphins,31,28,-3,0,1
163,2019,3,Bengals,Bills,17,21,4,1,0
164,2019,3,Dolphins,Cowboys,6,31,25,1,0
165,2019,3,Broncos,Packers,16,27,11,1,0
166,2020,3,Titans,Vikings,31,30,-1,0,1
167,2020,3,Raiders,Patriots,20,36,16,1,0
168,2020,3,49ers,Giants,36,9,-27,0,1
169,2021,3,Dolphins,Raiders,28,31,3,1,0
170,2021,3,Buccaneers,Rams,24,34,10,1,0
171,2021,3,Seahawks,Vikings,17,30,13,1,0
172,2018,3,Saints,Falcons,43,37,-6,0,1
173,2018,3,49ers,Chiefs,27,38,11,1,0
174,2018,3,Raiders,Dolphins,20,28,8,1,0
175,2021,2,Bengals,Bears,17,20,3,1,0
176,2021,2,Texans,Browns,21,31,10,1,0
177,2021,2,Rams,Colts,27,24,-3,0,1
178,2020,2,49ers,Jets,31,13,-18,0,1
179,2020,2,Rams,Eagles,37,19,-18,0,1
180,2020,2,Broncos,Steelers,21,26,5,1,0
181,2017,4,Bears,Packers,14,35,21,1,0
182,2019,3,Falcons,Colts,24,27,3,1,0
183,2019,3,Ravens,Chiefs,28,33,5,1,0
184,2019,3,Raiders,Vikings,14,34,20,1,0
185,2019,3,Jets,Patriots,14,30,16,1,0
186,2020,3,Texans,Steelers,21,28,7,1,0
187,2020,3,Jets,Colts,7,36,29,1,0
188,2021,3,Packers,49ers,30,28,-2,0,1
189,2021,3,Eagles,Cowboys,21,41,20,1,0
190,2018,3,Bills,Vikings,27,6,-21,0,1
191,2018,3,Colts,Eagles,16,20,4,1,0
192,2018,3,Packers,Washington,17,31,14,1,0
193,2021,2,Bills,Dolphins,35,0,-35,0,1
194,2021,2,Patriots,Jets,25,6,-19,0,1
195,2021,2,49ers,Eagles,17,11,-6,0,1
196,2020,2,Panthers,Buccaneers,17,31,14,1,0
197,2020,2,Washington,Cardinals,15,30,15,1,0
198,2020,2,Chiefs,Chargers,23,20,-3,0,1
199,2017,4,Saints,Dolphins,20,0,-20,0,1
200,2017,4,Bills,Falcons,23,17,-6,0,1
201,2017,4,Bengals,Browns,31,7,-24,0,1
202,2019,3,Lions,Eagles,27,24,-3,0,1
203,2019,3,Panthers,Cardinals,38,20,-18,0,1
204,2019,3,Giants,Buccaneers,32,31,-1,0,1
205,2020,3,Panthers,Chargers,21,16,-5,0,1
206,2020,3,Buccaneers,Broncos,28,10,-18,0,1
207,2020,3,Lions,Cardinals,26,23,-3,0,1
208,2018,3,Bengals,Panthers,21,31,10,1,0
209,2018,3,Titans,Jaguars,9,6,-3,0,1
210,2018,3,Broncos,Ravens,14,27,13,1,0
211,2021,2,Raiders,Steelers,26,17,-9,0,1
212,2021,2,Saints,Panthers,7,26,19,1,0
213,2021,2,Broncos,Jaguars,23,13,-10,0,1
214,2020,2,Ravens,Texans,33,16,-17,0,1
215,2020,2,Patriots,Seahawks,30,35,5,1,0
216,2020,2,Saints,Raiders,24,34,10,1,0
217,2017,4,Rams,Cowboys,35,30,-5,0,1
218,2017,4,Lions,Vikings,14,7,-7,0,1
219,2017,4,Panthers,Patriots,33,30,-3,0,1
220,2019,3,Texans,Chargers,27,20,-7,0,1
221,2019,3,Steelers,49ers,20,24,4,1,0
222,2019,3,Saints,Seahawks,33,27,-6,0,1
223,2020,3,Cowboys,Seahawks,31,38,7,1,0
224,2020,3,Packers,Saints,37,30,-7,0,1
225,2020,3,Chiefs,Ravens,34,20,-14,0,1
226,2018,3,Giants,Texans,27,22,-5,0,1
227,2018,3,Chargers,Rams,23,35,12,1,0
228,2018,3,Bears,Cardinals,16,14,-2,0,1
229,2021,2,Vikings,Cardinals,33,34,1,1,0
230,2021,2,Falcons,Buccaneers,25,48,23,1,0
231,2021,2,Cowboys,Chargers,20,17,-3,0,1
232,2017,4,Jaguars,Jets,20,23,3,1,0
233,2017,4,Steelers,Ravens,26,9,-17,0,1
234,2017,4,Titans,Texans,14,57,43,1,0
235,2019,3,Rams,Browns,20,13,-7,0,1
236,2019,3,Bears,Washington,31,15,-16,0,1
237,2018,3,Cowboys,Seahawks,13,24,11,1,0
238,2018,3,Patriots,Lions,10,26,16,1,0
239,2018,3,Steelers,Buccaneers,30,27,-3,0,1
240,2021,2,Titans,Seahawks,33,30,-3,0,1
241,2021,2,Chiefs,Ravens,35,36,1,1,0
242,2021,2,Lions,Packers,17,35,18,1,0
243,2017,4,49ers,Cardinals,15,18,3,1,0
244,2017,4,Eagles,Chargers,26,24,-2,0,1
245,2017,4,Giants,Buccaneers,23,25,2,1,0
246,2017,4,Raiders,Broncos,10,16,6,1,0
247,2017,4,Colts,Seahawks,18,46,28,1,0
248,2017,4,Washington,Chiefs,20,29,9,1,0
249,2020,5,Buccaneers,Bears,19,20,1,1,0
250,2020,5,Panthers,Falcons,23,16,-7,0,1
251,2020,5,Raiders,Chiefs,40,32,-8,0,1
252,2020,5,Cardinals,Jets,30,10,-20,0,1
253,2020,5,Eagles,Steelers,29,38,9,1,0
254,2020,5,Rams,Washington,30,10,-20,0,1
255,2020,5,Bengals,Ravens,3,27,24,1,0
256,2020,5,Jaguars,Texans,14,30,16,1,0
257,2020,5,Dolphins,49ers,43,17,-26,0,1
258,2020,5,Colts,Browns,23,32,9,1,0
259,2020,5,Giants,Cowboys,34,37,3,1,0
260,2020,5,Vikings,Seahawks,26,27,1,1,0
261,2020,5,Chargers,Saints,27,30,3,1,0
262,2020,5,Bills,Titans,16,42,26,1,0
263,2018,4,Vikings,Rams,31,38,7,1,0
264,2018,4,Bengals,Falcons,37,36,-1,0,1
265,2018,4,Buccaneers,Bears,10,48,38,1,0
266,2018,4,Lions,Cowboys,24,26,2,1,0
267,2018,4,Bills,Packers,0,22,22,1,0
268,2018,4,Eagles,Titans,23,26,3,1,0
269,2018,4,Texans,Colts,37,34,-3,0,1
270,2018,4,Dolphins,Patriots,7,38,31,1,0
271,2018,4,Jets,Jaguars,12,31,19,1,0
272,2018,4,Browns,Raiders,42,45,3,1,0
273,2018,4,Seahawks,Cardinals,20,17,-3,0,1
274,2018,4,Saints,Giants,33,18,-15,0,1
275,2018,4,49ers,Chargers,27,29,2,1,0
276,2018,4,Ravens,Steelers,26,14,-12,0,1
277,2018,4,Chiefs,Broncos,27,23,-4,0,1
278,2017,5,Patriots,Buccaneers,19,14,-5,0,1
279,2017,5,Bills,Bengals,16,20,4,1,0
280,2017,5,Jets,Browns,17,14,-3,0,1
281,2017,5,Panthers,Lions,27,24,-3,0,1
282,2017,5,49ers,Colts,23,26,3,1,0
283,2017,5,Titans,Dolphins,10,16,6,1,0
284,2017,5,Chargers,Giants,27,22,-5,0,1
285,2017,5,Cardinals,Eagles,7,34,27,1,0
286,2017,5,Jaguars,Steelers,30,9,-21,0,1
287,2017,5,Ravens,Raiders,30,17,-13,0,1
288,2017,5,Seahawks,Rams,16,10,-6,0,1
289,2020,4,Broncos,Jets,37,28,-9,0,1
290,2017,5,Packers,Cowboys,35,31,-4,0,1
291,2017,5,Chiefs,Texans,42,34,-8,0,1
292,2017,5,Vikings,Bears,20,17,-3,0,1
293,2018,5,Colts,Patriots,24,38,14,1,0
294,2020,4,Jaguars,Bengals,25,33,8,1,0
295,2020,4,Browns,Cowboys,49,38,-11,0,1
296,2020,4,Saints,Lions,35,29,-6,0,1
297,2018,5,Titans,Bills,12,13,1,1,0
298,2018,5,Dolphins,Bengals,17,27,10,1,0
299,2018,5,Ravens,Browns,9,12,3,1,0
300,2021,4,Jaguars,Bengals,21,24,3,1,0
301,2020,4,Seahawks,Dolphins,31,23,-8,0,1
302,2020,4,Chargers,Buccaneers,31,38,7,1,0
303,2020,4,Ravens,Washington,31,17,-14,0,1
304,2019,4,Eagles,Packers,34,27,-7,0,1
305,2018,5,Packers,Lions,23,31,8,1,0
306,2018,5,Jaguars,Chiefs,14,30,16,1,0
307,2018,5,Broncos,Jets,16,34,18,1,0
308,2021,4,Washington,Falcons,34,30,-4,0,1
309,2021,4,Texans,Bills,0,40,40,1,0
310,2021,4,Lions,Bears,14,24,10,1,0
311,2019,5,Rams,Seahawks,29,30,1,1,0
312,2020,4,Cardinals,Panthers,21,31,10,1,0
313,2020,4,Vikings,Texans,31,23,-8,0,1
314,2020,4,Giants,Rams,9,17,8,1,0
315,2019,4,Titans,Falcons,24,10,-14,0,1
316,2019,4,Patriots,Bills,16,10,-6,0,1
317,2019,4,Chiefs,Lions,34,30,-4,0,1
318,2018,5,Falcons,Steelers,17,41,24,1,0
319,2018,5,Giants,Panthers,31,33,2,1,0
320,2018,5,Raiders,Chargers,10,26,16,1,0
321,2021,4,Panthers,Cowboys,28,36,8,1,0
322,2021,4,Colts,Dolphins,27,17,-10,0,1
323,2021,4,Browns,Vikings,14,7,-7,0,1
324,2019,5,Cardinals,Bengals,26,23,-3,0,1
325,2019,5,Bills,Titans,14,7,-7,0,1
326,2019,5,Bears,Raiders,21,24,3,1,0
327,2020,4,Colts,Bears,19,11,-8,0,1
328,2020,4,Bills,Raiders,30,23,-7,0,1
329,2020,4,Eagles,49ers,25,20,-5,0,1
330,2019,4,Raiders,Colts,31,24,-7,0,1
331,2019,4,Chargers,Dolphins,30,10,-20,0,1
332,2019,4,Washington,Giants,3,24,21,1,0
333,2018,5,Vikings,Eagles,23,21,-2,0,1
334,2018,5,Cardinals,49ers,28,18,-10,0,1
335,2018,5,Rams,Seahawks,33,31,-2,0,1
336,2018,5,Cowboys,Texans,16,19,3,1,0
337,2021,4,Giants,Saints,27,21,-6,0,1
338,2021,4,Titans,Jets,24,27,3,1,0
339,2021,4,Chiefs,Eagles,42,30,-12,0,1
340,2019,5,Buccaneers,Saints,24,31,7,1,0
341,2019,5,Vikings,Giants,28,10,-18,0,1
342,2019,5,Jets,Eagles,6,31,25,1,0
343,2020,4,Patriots,Chiefs,10,26,16,1,0
344,2020,4,Falcons,Packers,16,30,14,1,0
345,2019,4,Browns,Ravens,40,25,-15,0,1
346,2019,4,Panthers,Texans,16,10,-6,0,1
347,2019,4,Buccaneers,Rams,55,40,-15,0,1
348,2018,5,Washington,Saints,19,43,24,1,0
349,2021,4,Cardinals,Rams,37,20,-17,0,1
350,2021,4,Seahawks,49ers,28,21,-7,0,1
351,2021,4,Ravens,Broncos,23,7,-16,0,1
352,2019,5,Ravens,Steelers,26,23,-3,0,1
353,2019,5,Patriots,Washington,33,7,-26,0,1
354,2019,5,Jaguars,Panthers,27,34,7,1,0
355,2019,4,Seahawks,Cardinals,27,10,-17,0,1
356,2019,4,Vikings,Bears,6,16,10,1,0
357,2019,4,Jaguars,Broncos,26,24,-2,0,1
358,2019,4,Cowboys,Saints,10,12,2,1,0
359,2021,4,Steelers,Packers,17,27,10,1,0
360,2021,4,Buccaneers,Patriots,19,17,-2,0,1
361,2021,4,Raiders,Chargers,14,28,14,1,0
362,2019,5,Falcons,Texans,32,53,21,1,0
363,2019,5,Broncos,Chargers,20,13,-7,0,1
364,2019,5,Packers,Cowboys,34,24,-10,0,1
365,2019,4,Bengals,Steelers,3,27,24,1,0
366,2019,5,Colts,Chiefs,19,13,-6,0,1
367,2019,5,Browns,49ers,3,31,28,1,0
368,2018,7,Broncos,Cardinals,45,10,-35,0,1
369,2018,7,Titans,Chargers,19,20,1,1,0
370,2018,7,Patriots,Bears,38,31,-7,0,1
371,2018,7,Bills,Colts,5,37,32,1,0
372,2018,7,Lions,Dolphins,32,21,-11,0,1
373,2018,7,Vikings,Jets,37,17,-20,0,1
374,2018,7,Panthers,Eagles,21,17,-4,0,1
375,2018,7,Browns,Buccaneers,23,26,3,1,0
376,2018,7,Texans,Jaguars,20,7,-13,0,1
377,2018,7,Saints,Ravens,24,23,-1,0,1
378,2018,7,Rams,49ers,39,10,-29,0,1
379,2018,7,Cowboys,Washington,17,20,3,1,0
380,2018,7,Bengals,Chiefs,10,45,35,1,0
381,2018,7,Giants,Falcons,20,23,3,1,0
382,2021,5,Rams,Seahawks,26,17,-9,0,1
383,2021,5,Jets,Falcons,20,27,7,1,0
384,2021,5,Packers,Bengals,25,22,-3,0,1
385,2021,5,Lions,Vikings,17,19,2,1,0
386,2017,6,Eagles,Panthers,28,23,-5,0,1
387,2021,5,Broncos,Steelers,19,27,8,1,0
388,2021,5,Dolphins,Buccaneers,17,45,28,1,0
389,2021,5,Saints,Washington,33,22,-11,0,1
390,2017,6,Dolphins,Falcons,20,17,-3,0,1
391,2017,6,Packers,Vikings,10,23,13,1,0
392,2017,6,Lions,Saints,38,52,14,1,0
393,2021,5,Eagles,Panthers,21,18,-3,0,1
394,2021,5,Titans,Jaguars,37,19,-18,0,1
395,2021,5,Patriots,Texans,25,22,-3,0,1
396,2017,6,Patriots,Jets,24,17,-7,0,1
397,2017,6,49ers,Washington,24,26,2,1,0
398,2017,6,Bears,Ravens,27,24,-3,0,1
399,2021,5,Bears,Raiders,20,9,-11,0,1
400,2021,5,Browns,Chargers,42,47,5,1,0
401,2021,5,Giants,Cowboys,20,44,24,1,0
402,2017,6,Browns,Texans,17,33,16,1,0
403,2017,6,Buccaneers,Cardinals,33,38,5,1,0
404,2017,6,Rams,Jaguars,27,17,-10,0,1
405,2021,5,49ers,Cardinals,10,17,7,1,0
406,2021,5,Bills,Chiefs,38,20,-18,0,1
407,2021,5,Colts,Ravens,25,31,6,1,0
408,2017,6,Steelers,Chiefs,19,13,-6,0,1
409,2017,6,Chargers,Raiders,17,16,-1,0,1
410,2017,6,Giants,Broncos,23,10,-13,0,1
411,2017,6,Colts,Titans,22,36,14,1,0
412,2018,6,Eagles,Giants,34,13,-21,0,1
413,2018,6,Buccaneers,Falcons,29,34,5,1,0
414,2018,6,Steelers,Bengals,28,21,-7,0,1
415,2018,6,Chargers,Browns,38,14,-24,0,1
416,2018,6,Seahawks,Raiders,27,3,-24,0,1
417,2018,6,Bears,Dolphins,28,31,3,1,0
418,2018,6,Cardinals,Vikings,17,27,10,1,0
419,2018,6,Colts,Jets,34,42,8,1,0
420,2018,6,Panthers,Washington,17,23,6,1,0
421,2018,6,Bills,Texans,13,20,7,1,0
422,2020,6,Texans,Titans,36,42,6,1,0
423,2018,6,Rams,Broncos,23,20,-3,0,1
424,2018,6,Jaguars,Cowboys,7,40,33,1,0
425,2018,6,Ravens,Titans,21,0,-21,0,1
426,2020,6,Bengals,Colts,27,31,4,1,0
427,2020,6,Falcons,Vikings,40,23,-17,0,1
428,2020,6,Broncos,Patriots,18,12,-6,0,1
429,2018,6,Chiefs,Patriots,40,43,3,1,0
430,2018,6,49ers,Packers,30,33,3,1,0
431,2019,6,Giants,Patriots,14,35,21,1,0
432,2017,7,Chiefs,Raiders,30,31,1,1,0
433,2020,6,Washington,Giants,19,20,1,1,0
434,2020,6,Ravens,Eagles,30,28,-2,0,1
435,2020,6,Browns,Steelers,7,38,31,1,0
436,2019,6,Panthers,Buccaneers,37,26,-11,0,1
437,2019,6,Seahawks,Browns,32,28,-4,0,1
438,2019,6,Texans,Chiefs,31,24,-7,0,1
439,2017,7,Buccaneers,Bills,27,30,3,1,0
440,2017,7,Panthers,Bears,3,17,14,1,0
441,2017,7,Titans,Browns,12,9,-3,0,1
442,2021,6,Buccaneers,Eagles,28,22,-6,0,1
443,2020,6,Bears,Panthers,23,16,-7,0,1
444,2020,6,Lions,Jaguars,34,16,-18,0,1
445,2020,6,Jets,Dolphins,0,24,24,1,0
446,2019,6,Washington,Dolphins,17,16,-1,0,1
447,2019,6,Eagles,Vikings,20,38,18,1,0
448,2019,6,Saints,Jaguars,13,6,-7,0,1
449,2017,7,Saints,Packers,26,17,-9,0,1
450,2017,7,Jaguars,Colts,27,0,-27,0,1
451,2017,7,Cardinals,Rams,0,33,33,1,0
452,2021,6,Dolphins,Jaguars,20,23,3,1,0
453,2021,6,Packers,Bears,24,14,-10,0,1
454,2021,6,Bengals,Lions,34,11,-23,0,1
455,2020,6,Packers,Buccaneers,10,38,28,1,0
456,2020,6,Rams,49ers,16,24,8,1,0
457,2020,6,Chiefs,Bills,26,17,-9,0,1
458,2019,6,Bengals,Ravens,17,23,6,1,0
459,2019,6,49ers,Rams,20,7,-13,0,1
460,2019,6,Falcons,Cardinals,33,34,1,1,0
461,2017,7,Jets,Dolphins,28,31,3,1,0
462,2017,7,Ravens,Vikings,16,24,8,1,0
463,2017,7,Cowboys,49ers,40,10,-30,0,1
464,2021,6,Texans,Colts,3,31,28,1,0
465,2021,6,Rams,Giants,38,11,-27,0,1
466,2021,6,Chiefs,Washington,31,13,-18,0,1
467,2020,6,Cardinals,Cowboys,38,10,-28,0,1
468,2019,6,Titans,Broncos,0,16,16,1,0
469,2019,6,Cowboys,Jets,22,24,2,1,0
470,2019,6,Steelers,Chargers,24,17,-7,0,1
471,2019,6,Lions,Packers,22,23,1,1,0
472,2017,7,Seahawks,Giants,24,7,-17,0,1
473,2017,7,Bengals,Steelers,14,29,15,1,0
474,2017,7,Broncos,Chargers,0,21,21,1,0
475,2017,7,Falcons,Patriots,7,23,16,1,0
476,2021,6,Vikings,Panthers,34,28,-6,0,1
477,2021,6,Chargers,Ravens,6,34,28,1,0
478,2021,6,Cardinals,Browns,37,14,-23,0,1
479,2017,7,Washington,Eagles,24,34,10,1,0
480,2021,6,Raiders,Broncos,34,24,-10,0,1
481,2021,6,Cowboys,Patriots,35,29,-6,0,1
482,2021,6,Seahawks,Steelers,20,23,3,1,0
483,2021,6,Bills,Titans,31,34,3,1,0
484,2020,7,Giants,Eagles,21,22,1,1,0
485,2020,7,Lions,Falcons,23,22,-1,0,1
486,2020,7,Browns,Bengals,37,34,-3,0,1
487,2020,7,Steelers,Titans,27,24,-3,0,1
488,2020,7,Panthers,Saints,24,27,3,1,0
489,2020,7,Bills,Jets,18,10,-8,0,1
490,2020,7,Cowboys,Washington,3,25,22,1,0
491,2020,7,Packers,Texans,35,20,-15,0,1
492,2020,7,Buccaneers,Raiders,45,20,-25,0,1
493,2020,7,Chiefs,Broncos,43,16,-27,0,1
494,2021,7,Broncos,Browns,14,17,3,1,0
495,2020,7,49ers,Patriots,33,6,-27,0,1
496,2020,7,Jaguars,Chargers,29,39,10,1,0
497,2020,7,Seahawks,Cardinals,34,37,3,1,0
498,2021,7,Washington,Packers,10,24,14,1,0
499,2021,7,Chiefs,Titans,3,27,24,1,0
500,2021,7,Falcons,Dolphins,30,28,-2,0,1
501,2020,7,Bears,Rams,10,24,14,1,0
502,2021,7,Jets,Patriots,13,54,41,1,0
503,2021,7,Panthers,Giants,3,25,22,1,0
504,2021,7,Bengals,Ravens,41,17,-24,0,1
505,2021,7,Eagles,Raiders,22,33,11,1,0
506,2021,7,Lions,Rams,19,28,9,1,0
507,2021,7,Texans,Cardinals,5,31,26,1,0
508,2021,7,Bears,Buccaneers,3,38,35,1,0
509,2021,7,Colts,49ers,30,18,-12,0,1
510,2021,7,Saints,Seahawks,13,10,-3,0,1
511,2019,7,Chiefs,Broncos,30,6,-24,0,1
512,2019,7,Rams,Falcons,37,10,-27,0,1
513,2019,7,Dolphins,Bills,21,31,10,1,0
514,2019,7,Jaguars,Bengals,27,17,-10,0,1
515,2019,7,Vikings,Lions,42,30,-12,0,1
516,2019,7,Raiders,Packers,24,42,18,1,0
517,2019,7,Texans,Colts,23,30,7,1,0
518,2019,7,Cardinals,Giants,27,21,-6,0,1
519,2017,8,Dolphins,Ravens,0,40,40,1,0
520,2019,7,49ers,Washington,9,0,-9,0,1
521,2019,7,Chargers,Titans,20,23,3,1,0
522,2019,7,Saints,Bears,36,25,-11,0,1
523,2017,8,Vikings,Browns,33,16,-17,0,1
524,2017,8,Raiders,Bills,14,34,20,1,0
525,2017,8,Colts,Bengals,23,24,1,1,0
526,2019,7,Ravens,Seahawks,30,16,-14,0,1
527,2019,7,Eagles,Cowboys,10,37,27,1,0
528,2019,7,Patriots,Jets,33,0,-33,0,1
529,2017,8,Chargers,Patriots,13,21,8,1,0
530,2017,8,Bears,Saints,12,20,8,1,0
531,2017,8,Falcons,Jets,25,20,-5,0,1
532,2019,8,Washington,Vikings,9,19,10,1,0
533,2018,8,Dolphins,Texans,23,42,19,1,0
534,2017,8,49ers,Eagles,10,33,23,1,0
535,2017,8,Panthers,Buccaneers,17,3,-14,0,1
536,2017,8,Texans,Seahawks,38,41,3,1,0
537,2017,8,Cowboys,Washington,33,19,-14,0,1
538,2019,8,Seahawks,Falcons,27,20,-7,0,1
539,2019,8,Eagles,Bills,31,13,-18,0,1
540,2019,8,Chargers,Bears,17,16,-1,0,1
541,2018,8,Eagles,Jaguars,24,18,-6,0,1
542,2018,8,Jets,Bears,10,24,14,1,0
543,2018,8,Buccaneers,Bengals,34,37,3,1,0
544,2021,8,Packers,Cardinals,24,21,-3,0,1
545,2017,8,Steelers,Lions,20,15,-5,0,1
546,2017,8,Broncos,Chiefs,19,29,10,1,0
547,2019,8,Giants,Lions,26,31,5,1,0
548,2019,8,Buccaneers,Titans,23,27,4,1,0
549,2019,8,Broncos,Colts,13,15,2,1,0
550,2018,8,Seahawks,Lions,28,14,-14,0,1
551,2018,8,Broncos,Chiefs,23,30,7,1,0
552,2018,8,Washington,Giants,20,13,-7,0,1
553,2021,8,Panthers,Falcons,19,13,-6,0,1
554,2021,8,Dolphins,Bills,11,26,15,1,0
555,2021,8,49ers,Bears,33,22,-11,0,1
556,2020,8,Falcons,Panthers,25,17,-8,0,1
557,2017,9,Bills,Jets,21,34,13,1,0
558,2019,8,Bengals,Rams,10,24,14,1,0
559,2019,8,Cardinals,Saints,9,31,22,1,0
560,2019,8,Jets,Jaguars,15,29,14,1,0
561,2018,8,Browns,Steelers,18,33,15,1,0
562,2018,8,Ravens,Panthers,21,36,15,1,0
563,2018,8,Colts,Raiders,42,28,-14,0,1
564,2021,8,Steelers,Browns,15,10,-5,0,1
565,2021,8,Eagles,Lions,44,6,-38,0,1
566,2021,8,Titans,Colts,34,31,-3,0,1
567,2020,8,Patriots,Bills,21,24,3,1,0
568,2020,8,Titans,Bengals,20,31,11,1,0
569,2020,8,Raiders,Browns,16,6,-10,0,1
570,2017,9,Ravens,Titans,20,23,3,1,0
571,2017,9,Buccaneers,Saints,10,30,20,1,0
572,2017,9,Rams,Giants,51,17,-34,0,1
573,2019,8,Panthers,49ers,13,51,38,1,0
574,2019,8,Browns,Patriots,13,27,14,1,0
575,2019,8,Raiders,Texans,24,27,3,1,0
576,2018,8,Packers,Rams,27,29,2,1,0
577,2018,8,49ers,Cardinals,15,18,3,1,0
578,2018,8,Saints,Vikings,30,20,-10,0,1
579,2021,8,Bengals,Jets,31,34,3,1,0
580,2021,8,Rams,Texans,38,22,-16,0,1
581,2021,8,Patriots,Chargers,27,24,-3,0,1
582,2020,8,Colts,Lions,41,21,-20,0,1
583,2020,8,Vikings,Packers,28,22,-6,0,1
584,2020,8,Jets,Chiefs,9,35,26,1,0
585,2017,9,Broncos,Eagles,23,51,28,1,0
586,2017,9,Falcons,Panthers,17,20,3,1,0
587,2017,9,Bengals,Jaguars,7,23,16,1,0
588,2019,8,Packers,Chiefs,31,24,-7,0,1
589,2019,8,Dolphins,Steelers,14,27,13,1,0
590,2018,8,Patriots,Bills,25,6,-19,0,1
591,2021,8,Jaguars,Seahawks,7,31,24,1,0
592,2021,8,Washington,Broncos,10,17,7,1,0
593,2021,8,Buccaneers,Saints,27,36,9,1,0
594,2020,8,Rams,Dolphins,17,28,11,1,0
595,2020,8,Steelers,Ravens,28,24,-4,0,1
596,2020,8,Chargers,Broncos,30,31,1,1,0
597,2017,9,Colts,Texans,20,14,-6,0,1
598,2017,9,Cardinals,49ers,20,10,-10,0,1
599,2017,9,Washington,Seahawks,17,14,-3,0,1
600,2021,8,Cowboys,Vikings,20,16,-4,0,1
601,2021,8,Giants,Chiefs,17,20,3,1,0
602,2020,8,Saints,Bears,26,23,-3,0,1
603,2020,8,49ers,Seahawks,27,37,10,1,0
604,2020,8,Cowboys,Eagles,9,23,14,1,0
605,2017,9,Chiefs,Cowboys,17,28,11,1,0
606,2017,9,Raiders,Dolphins,27,24,-3,0,1
607,2017,9,Lions,Packers,30,17,-13,0,1
608,2020,9,Packers,49ers,34,17,-17,0,1
609,2020,8,Buccaneers,Giants,25,23,-2,0,1
610,2020,9,Broncos,Falcons,27,34,7,1,0
611,2020,9,Seahawks,Bills,34,44,10,1,0
612,2020,9,Bears,Titans,17,24,7,1,0
613,2018,10,Panthers,Steelers,21,52,31,1,0
614,2020,9,Ravens,Colts,24,10,-14,0,1
615,2020,9,Panthers,Chiefs,31,33,2,1,0
616,2020,9,Lions,Vikings,20,34,14,1,0
617,2018,10,Lions,Bears,22,34,12,1,0
618,2018,10,Saints,Bengals,51,14,-37,0,1
619,2018,10,Falcons,Browns,16,28,12,1,0
620,2020,9,Giants,Washington,23,20,-3,0,1
621,2020,9,Texans,Jaguars,27,25,-2,0,1
622,2020,9,Raiders,Chargers,31,26,-5,0,1
623,2020,9,Steelers,Cowboys,24,19,-5,0,1
624,2018,9,Raiders,49ers,3,34,31,1,0
625,2018,10,Patriots,Titans,10,34,24,1,0
626,2018,10,Jaguars,Colts,26,29,3,1,0
627,2018,10,Cardinals,Chiefs,14,26,12,1,0
628,2020,9,Dolphins,Cardinals,34,31,-3,0,1
629,2020,9,Saints,Buccaneers,38,3,-35,0,1
630,2020,9,Patriots,Jets,30,27,-3,0,1
631,2018,9,Bears,Bills,41,9,-32,0,1
632,2018,9,Chiefs,Browns,37,21,-16,0,1
633,2018,9,Jets,Dolphins,6,13,7,1,0
634,2018,9,Lions,Vikings,9,24,15,1,0
635,2018,10,Bills,Jets,41,10,-31,0,1
636,2018,10,Washington,Buccaneers,16,3,-13,0,1
637,2018,10,Chargers,Raiders,20,6,-14,0,1
638,2018,9,Falcons,Washington,38,14,-24,0,1
639,2018,9,Buccaneers,Panthers,28,42,14,1,0
640,2018,9,Steelers,Ravens,23,16,-7,0,1
641,2018,10,Dolphins,Packers,12,31,19,1,0
642,2018,10,Seahawks,Rams,31,36,5,1,0
643,2018,10,Cowboys,Eagles,27,20,-7,0,1
644,2018,9,Texans,Broncos,19,17,-2,0,1
645,2018,9,Chargers,Seahawks,25,17,-8,0,1
646,2018,9,Rams,Saints,35,45,10,1,0
647,2018,10,Giants,49ers,27,23,-4,0,1
648,2018,9,Packers,Patriots,17,31,14,1,0
649,2018,9,Titans,Cowboys,28,14,-14,0,1
650,2019,9,49ers,Cardinals,28,25,-3,0,1
651,2019,9,Texans,Jaguars,26,3,-23,0,1
652,2019,9,Washington,Bills,9,24,15,1,0
653,2019,9,Vikings,Chiefs,23,26,3,1,0
654,2019,9,Jets,Dolphins,18,26,8,1,0
655,2019,9,Bears,Eagles,14,22,8,1,0
656,2019,9,Colts,Steelers,24,26,2,1,0
657,2019,9,Titans,Panthers,20,30,10,1,0
658,2019,9,Lions,Raiders,24,31,7,1,0
659,2019,9,Buccaneers,Seahawks,34,40,6,1,0
660,2019,9,Browns,Broncos,19,24,5,1,0
661,2019,9,Packers,Chargers,11,26,15,1,0
662,2019,9,Patriots,Ravens,20,37,17,1,0
663,2019,9,Cowboys,Giants,37,18,-19,0,1
664,2021,9,Jets,Colts,30,45,15,1,0
665,2021,9,Browns,Bengals,41,16,-25,0,1
666,2021,9,Broncos,Cowboys,30,16,-14,0,1
667,2021,9,Texans,Dolphins,9,17,8,1,0
668,2017,10,Seahawks,Cardinals,22,16,-6,0,1
669,2021,9,Falcons,Saints,27,25,-2,0,1
670,2021,9,Raiders,Giants,16,23,7,1,0
671,2021,9,Patriots,Panthers,24,6,-18,0,1
672,2017,10,Saints,Bills,47,10,-37,0,1
673,2017,10,Packers,Bears,23,16,-7,0,1
674,2017,10,Browns,Lions,24,38,14,1,0
675,2017,10,Bengals,Titans,20,24,4,1,0
676,2021,9,Bills,Jaguars,6,9,3,1,0
677,2021,9,Vikings,Ravens,31,34,3,1,0
678,2021,9,Chargers,Eagles,27,24,-3,0,1
679,2017,10,Steelers,Colts,20,17,-3,0,1
680,2017,10,Jets,Buccaneers,10,15,5,1,0
681,2017,10,Vikings,Washington,38,30,-8,0,1
682,2021,9,Packers,Chiefs,7,13,6,1,0
683,2021,9,Cardinals,49ers,31,17,-14,0,1
684,2021,9,Titans,Rams,28,16,-12,0,1
685,2017,10,Chargers,Jaguars,17,20,3,1,0
686,2017,10,Texans,Rams,7,33,26,1,0
687,2017,10,Cowboys,Falcons,7,27,20,1,0
688,2021,9,Bears,Steelers,27,29,2,1,0
689,2017,10,Giants,49ers,21,31,10,1,0
690,2017,10,Patriots,Broncos,41,16,-25,0,1
691,2017,10,Dolphins,Panthers,21,45,24,1,0
692,2020,10,Colts,Titans,34,17,-17,0,1
693,2019,10,Chargers,Raiders,24,26,2,1,0
694,2020,10,Texans,Browns,7,10,3,1,0
695,2020,10,Washington,Lions,27,30,3,1,0
696,2020,10,Jaguars,Packers,20,24,4,1,0
697,2019,10,Lions,Bears,13,20,7,1,0
698,2019,10,Ravens,Bengals,49,13,-36,0,1
699,2019,10,Bills,Browns,16,19,3,1,0
700,2019,10,Chiefs,Titans,32,35,3,1,0
701,2020,10,Eagles,Giants,17,27,10,1,0
702,2020,10,Buccaneers,Panthers,46,23,-23,0,1
703,2020,10,Broncos,Raiders,12,37,25,1,0
704,2019,10,Falcons,Saints,26,9,-17,0,1
705,2019,10,Giants,Jets,27,34,7,1,0
706,2019,10,Cardinals,Buccaneers,27,30,3,1,0
707,2020,10,Chargers,Dolphins,21,29,8,1,0
708,2020,10,Bills,Cardinals,30,32,2,1,0
709,2020,10,Seahawks,Rams,16,23,7,1,0
710,2019,10,Dolphins,Colts,16,12,-4,0,1
711,2019,10,Panthers,Packers,16,24,8,1,0
712,2019,10,Rams,Steelers,12,17,5,1,0
713,2019,10,Vikings,Cowboys,28,24,-4,0,1
714,2020,10,49ers,Saints,13,27,14,1,0
715,2020,10,Bengals,Steelers,10,36,26,1,0
716,2020,10,Ravens,Patriots,17,23,6,1,0
717,2019,10,Seahawks,49ers,27,24,-3,0,1
718,2020,10,Vikings,Bears,19,13,-6,0,1
719,2021,10,Ravens,Dolphins,10,22,12,1,0
720,2021,10,Falcons,Cowboys,3,43,40,1,0
721,2021,10,Saints,Titans,21,23,2,1,0
722,2021,10,Jaguars,Colts,17,23,6,1,0
723,2021,10,Browns,Patriots,7,45,38,1,0
724,2021,10,Bills,Jets,45,17,-28,0,1
725,2021,10,Buccaneers,Washington,19,29,10,1,0
726,2021,10,Panthers,Cardinals,34,10,-24,0,1
727,2021,10,Vikings,Chargers,27,20,-7,0,1
728,2021,10,Eagles,Broncos,30,13,-17,0,1
729,2021,10,Seahawks,Packers,0,17,17,1,0
730,2021,10,Chiefs,Raiders,41,14,-27,0,1
731,2021,10,Rams,49ers,10,31,21,1,0
732,2020,11,Cardinals,Seahawks,21,28,7,1,0
733,2020,11,Eagles,Browns,17,22,5,1,0
734,2020,11,Falcons,Saints,9,24,15,1,0
735,2020,11,Bengals,Washington,9,20,11,1,0
736,2020,11,Lions,Panthers,0,20,20,1,0
737,2020,11,Steelers,Jaguars,27,3,-24,0,1
738,2020,11,Titans,Ravens,30,24,-6,0,1
739,2020,11,Patriots,Texans,20,27,7,1,0
740,2020,11,Dolphins,Broncos,13,20,7,1,0
741,2020,11,Jets,Chargers,28,34,6,1,0
742,2020,11,Packers,Colts,31,34,3,1,0
743,2020,11,Cowboys,Vikings,31,28,-3,0,1
744,2020,11,Chiefs,Raiders,35,31,-4,0,1
745,2020,11,Rams,Buccaneers,27,24,-3,0,1
746,2017,11,Titans,Steelers,17,40,23,1,0
747,2017,11,Lions,Bears,27,24,-3,0,1
748,2017,11,Jaguars,Browns,19,7,-12,0,1
749,2017,11,Ravens,Packers,23,0,-23,0,1
750,2017,11,Buccaneers,Dolphins,30,20,-10,0,1
751,2018,11,Packers,Seahawks,24,27,3,1,0
752,2017,11,Rams,Vikings,7,24,17,1,0
753,2017,11,Washington,Saints,31,34,3,1,0
754,2017,11,Chiefs,Giants,9,12,3,1,0
755,2018,11,Cowboys,Falcons,22,19,-3,0,1
756,2018,11,Panthers,Lions,19,20,1,1,0
757,2018,11,Titans,Colts,10,38,28,1,0
758,2017,11,Cardinals,Texans,21,31,10,1,0
759,2017,11,Bills,Chargers,24,54,30,1,0
760,2017,11,Bengals,Broncos,20,17,-3,0,1
761,2018,11,Buccaneers,Giants,35,38,3,1,0
762,2018,11,Texans,Washington,23,21,-2,0,1
763,2018,11,Steelers,Jaguars,20,16,-4,0,1
764,2018,11,Bengals,Ravens,21,24,3,1,0
765,2017,11,Patriots,Raiders,33,8,-25,0,1
766,2017,11,Eagles,Cowboys,37,9,-28,0,1
767,2017,11,Falcons,Seahawks,34,31,-3,0,1
768,2018,11,Raiders,Cardinals,23,21,-2,0,1
769,2018,11,Broncos,Chargers,23,22,-1,0,1
770,2018,11,Eagles,Saints,7,48,41,1,0
771,2018,11,Vikings,Bears,20,25,5,1,0
772,2018,11,Chiefs,Rams,51,54,3,1,0
773,2019,11,Steelers,Browns,7,21,14,1,0
774,2019,11,Cowboys,Lions,35,27,-8,0,1
775,2019,11,Jaguars,Colts,13,33,20,1,0
776,2019,11,Bills,Dolphins,37,20,-17,0,1
777,2019,11,Broncos,Vikings,23,27,4,1,0
778,2019,11,Saints,Buccaneers,34,17,-17,0,1
779,2019,11,Jets,Washington,34,17,-17,0,1
780,2019,11,Falcons,Panthers,29,3,-26,0,1
781,2019,11,Texans,Ravens,7,41,34,1,0
782,2019,11,Cardinals,49ers,26,36,10,1,0
783,2019,11,Bengals,Raiders,10,17,7,1,0
784,2019,11,Patriots,Eagles,17,10,-7,0,1
785,2019,11,Bears,Rams,7,17,10,1,0
786,2019,11,Chiefs,Chargers,24,17,-7,0,1
787,2017,12,Vikings,Lions,30,23,-7,0,1
788,2017,12,Chargers,Cowboys,28,6,-22,0,1
789,2017,12,Giants,Washington,10,20,10,1,0
790,2021,11,Patriots,Falcons,25,0,-25,0,1
791,2018,12,Bears,Lions,23,16,-7,0,1
792,2017,12,Buccaneers,Falcons,20,34,14,1,0
793,2017,12,Browns,Bengals,16,30,14,1,0
794,2017,12,Titans,Colts,20,16,-4,0,1
795,2021,11,Colts,Bills,41,15,-26,0,1
796,2021,11,Ravens,Bears,16,13,-3,0,1
797,2021,11,Lions,Browns,10,13,3,1,0
798,2018,12,Washington,Cowboys,23,31,8,1,0
799,2018,12,Falcons,Saints,17,31,14,1,0
800,2018,12,Jaguars,Bills,21,24,3,1,0
801,2017,12,Bills,Chiefs,16,10,-6,0,1
802,2017,12,Dolphins,Patriots,17,35,18,1,0
803,2017,12,Panthers,Jets,35,27,-8,0,1
804,2021,11,Texans,Titans,22,13,-9,0,1
805,2021,11,Packers,Vikings,31,34,3,1,0
806,2021,11,Dolphins,Jets,24,17,-7,0,1
807,2020,12,Texans,Lions,41,25,-16,0,1
808,2018,12,Browns,Bengals,35,20,-15,0,1
809,2018,12,Patriots,Jets,27,13,-14,0,1
810,2018,12,Giants,Eagles,22,25,3,1,0
811,2017,12,Bears,Eagles,3,31,28,1,0
812,2017,12,Seahawks,49ers,24,13,-11,0,1
813,2017,12,Broncos,Raiders,14,21,7,1,0
814,2021,11,Saints,Eagles,29,40,11,1,0
815,2021,11,Washington,Panthers,27,21,-6,0,1
816,2021,11,49ers,Jaguars,30,10,-20,0,1
817,2020,12,Washington,Cowboys,41,16,-25,0,1
818,2020,12,Raiders,Falcons,6,43,37,1,0
819,2020,12,Chargers,Bills,17,27,10,1,0
820,2018,12,49ers,Buccaneers,9,27,18,1,0
821,2018,12,Seahawks,Panthers,30,27,-3,0,1
822,2018,12,Raiders,Ravens,17,34,17,1,0
823,2017,12,Saints,Rams,20,26,6,1,0
824,2017,12,Jaguars,Cardinals,24,27,3,1,0
825,2017,12,Packers,Steelers,28,31,3,1,0
826,2021,11,Bengals,Raiders,32,13,-19,0,1
827,2021,11,Cowboys,Chiefs,9,19,10,1,0
828,2021,11,Cardinals,Seahawks,23,13,-10,0,1
829,2020,12,Giants,Bengals,19,17,-2,0,1
830,2020,12,Titans,Colts,45,26,-19,0,1
831,2020,12,Panthers,Vikings,27,28,1,1,0
832,2018,12,Cardinals,Chargers,10,45,35,1,0
833,2018,12,Steelers,Broncos,17,24,7,1,0
834,2018,12,Dolphins,Colts,24,27,3,1,0
835,2017,12,Texans,Ravens,16,23,7,1,0
836,2021,11,Steelers,Chargers,37,41,4,1,0
837,2021,11,Giants,Buccaneers,10,30,20,1,0
838,2020,12,Cardinals,Patriots,17,20,3,1,0
839,2020,12,Dolphins,Jets,20,3,-17,0,1
840,2020,12,Browns,Jaguars,27,25,-2,0,1
841,2018,12,Packers,Vikings,17,24,7,1,0
842,2018,12,Titans,Texans,17,34,17,1,0
843,2020,12,Saints,Broncos,31,3,-28,0,1
844,2020,12,49ers,Rams,23,20,-3,0,1
845,2020,12,Chiefs,Buccaneers,27,24,-3,0,1
846,2020,12,Bears,Packers,25,41,16,1,0
847,2020,12,Seahawks,Eagles,23,17,-6,0,1
848,2020,12,Ravens,Steelers,14,19,5,1,0
849,2019,12,Colts,Texans,17,20,3,1,0
850,2019,12,Buccaneers,Falcons,35,22,-13,0,1
851,2019,12,Broncos,Bills,3,20,17,1,0
852,2019,12,Giants,Bears,14,19,5,1,0
853,2019,12,Steelers,Bengals,16,10,-6,0,1
854,2019,12,Dolphins,Browns,24,41,17,1,0
855,2019,12,Panthers,Saints,31,34,3,1,0
856,2019,12,Raiders,Jets,3,34,31,1,0
857,2019,12,Seahawks,Eagles,17,9,-8,0,1
858,2019,12,Lions,Washington,16,19,3,1,0
859,2019,12,Jaguars,Titans,20,42,22,1,0
860,2019,12,Cowboys,Patriots,9,13,4,1,0
861,2019,12,Packers,49ers,8,37,29,1,0
862,2019,12,Ravens,Rams,45,6,-39,0,1
863,2019,13,Bears,Lions,24,20,-4,0,1
864,2019,13,Bills,Cowboys,26,15,-11,0,1
865,2019,13,Saints,Falcons,26,18,-8,0,1
866,2019,13,Jets,Bengals,6,22,16,1,0
867,2021,12,Bears,Lions,16,14,-2,0,1
868,2019,13,Titans,Colts,31,17,-14,0,1
869,2019,13,Eagles,Dolphins,31,37,6,1,0
870,2019,13,Packers,Giants,31,13,-18,0,1
871,2021,12,Raiders,Cowboys,36,33,-3,0,1
872,2021,12,Bills,Saints,31,6,-25,0,1
873,2021,12,Steelers,Bengals,10,41,31,1,0
874,2019,13,Browns,Steelers,13,20,7,1,0
875,2019,13,Washington,Panthers,29,21,-8,0,1
876,2019,13,Buccaneers,Jaguars,28,11,-17,0,1
877,2019,13,49ers,Ravens,17,20,3,1,0
878,2020,13,Saints,Falcons,21,16,-5,0,1
879,2021,12,Buccaneers,Colts,38,31,-7,0,1
880,2021,12,Panthers,Dolphins,10,33,23,1,0
881,2021,12,Titans,Patriots,13,36,23,1,0
882,2019,13,Rams,Cardinals,34,7,-27,0,1
883,2019,13,Chargers,Broncos,20,23,3,1,0
884,2019,13,Raiders,Chiefs,9,40,31,1,0
885,2020,13,Lions,Bears,34,30,-4,0,1
886,2020,13,Browns,Titans,41,35,-6,0,1
887,2020,13,Bengals,Dolphins,7,19,12,1,0
888,2021,12,Eagles,Giants,7,13,6,1,0
889,2021,12,Falcons,Jaguars,21,14,-7,0,1
890,2021,12,Jets,Texans,21,14,-7,0,1
891,2019,13,Patriots,Texans,22,28,6,1,0
892,2019,13,Vikings,Seahawks,30,37,7,1,0
893,2017,13,Washington,Cowboys,14,38,24,1,0
894,2020,13,Jaguars,Vikings,24,27,3,1,0
895,2020,13,Raiders,Jets,31,28,-3,0,1
896,2020,13,Colts,Texans,26,20,-6,0,1
897,2021,12,Chargers,Broncos,13,28,15,1,0
898,2021,12,Rams,Packers,28,36,8,1,0
899,2021,12,Vikings,49ers,26,34,8,1,0
900,2017,13,Vikings,Falcons,14,9,-5,0,1
901,2017,13,Patriots,Bills,23,3,-20,0,1
902,2020,13,Rams,Cardinals,38,28,-10,0,1
903,2020,13,Giants,Seahawks,17,12,-5,0,1
904,2020,13,Eagles,Packers,16,30,14,1,0
905,2021,12,Browns,Ravens,10,16,6,1,0
906,2021,12,Seahawks,Washington,15,17,2,1,0
907,2017,13,49ers,Bears,15,14,-1,0,1
908,2017,13,Buccaneers,Packers,20,26,6,1,0
909,2017,13,Texans,Titans,13,24,11,1,0
910,2017,13,Broncos,Dolphins,9,35,26,1,0
911,2020,13,Patriots,Chargers,45,0,-45,0,1
912,2020,13,Broncos,Chiefs,16,22,6,1,0
913,2020,13,Washington,Steelers,23,17,-6,0,1
914,2017,13,Chiefs,Jets,31,38,7,1,0
915,2017,13,Colts,Jaguars,10,30,20,1,0
916,2017,13,Lions,Ravens,20,44,24,1,0
917,2018,13,Saints,Cowboys,10,13,3,1,0
918,2020,13,Bills,49ers,34,24,-10,0,1
919,2020,13,Cowboys,Ravens,17,34,17,1,0
920,2017,13,Browns,Chargers,10,19,9,1,0
921,2017,13,Giants,Raiders,17,24,7,1,0
922,2017,13,Panthers,Saints,21,31,10,1,0
923,2018,13,Ravens,Falcons,26,16,-10,0,1
924,2018,13,Broncos,Bengals,24,10,-14,0,1
925,2018,13,Rams,Lions,30,16,-14,0,1
926,2017,13,Rams,Cardinals,32,16,-16,0,1
927,2017,13,Eagles,Seahawks,10,24,14,1,0
928,2017,13,Steelers,Bengals,23,20,-3,0,1
929,2018,13,Cardinals,Packers,20,17,-3,0,1
930,2018,13,Bills,Dolphins,17,21,4,1,0
931,2018,13,Bears,Giants,27,30,3,1,0
932,2018,13,Panthers,Buccaneers,17,24,7,1,0
933,2018,13,Colts,Jaguars,0,6,6,1,0
934,2018,13,Browns,Texans,13,29,16,1,0
935,2018,14,Jaguars,Titans,9,30,21,1,0
936,2018,13,Jets,Titans,22,26,4,1,0
937,2018,13,Chiefs,Raiders,40,33,-7,0,1
938,2018,13,Vikings,Patriots,10,24,14,1,0
939,2018,14,Jets,Bills,27,23,-4,0,1
940,2018,14,Panthers,Browns,20,26,6,1,0
941,2018,14,Falcons,Packers,20,34,14,1,0
942,2018,13,49ers,Seahawks,16,43,27,1,0
943,2018,13,Chargers,Steelers,33,30,-3,0,1
944,2018,13,Washington,Eagles,13,28,15,1,0
945,2018,14,Ravens,Chiefs,24,27,3,1,0
946,2018,14,Patriots,Dolphins,33,34,1,1,0
947,2018,14,Saints,Buccaneers,28,14,-14,0,1
948,2018,14,Giants,Washington,40,16,-24,0,1
949,2018,14,Colts,Texans,24,21,-3,0,1
950,2018,14,Bengals,Chargers,21,26,5,1,0
951,2021,13,Cowboys,Saints,27,17,-10,0,1
952,2018,14,Broncos,49ers,14,20,6,1,0
953,2018,14,Eagles,Cowboys,23,29,6,1,0
954,2018,14,Steelers,Raiders,21,24,3,1,0
955,2018,14,Lions,Cardinals,17,3,-14,0,1
956,2021,13,Buccaneers,Falcons,30,17,-13,0,1
957,2021,13,Cardinals,Bears,33,22,-11,0,1
958,2021,13,Chargers,Bengals,41,22,-19,0,1
959,2018,14,Rams,Bears,6,15,9,1,0
960,2018,14,Vikings,Seahawks,7,21,14,1,0
961,2020,14,Patriots,Rams,3,24,21,1,0
962,2021,13,Vikings,Lions,27,29,2,1,0
963,2021,13,Giants,Dolphins,9,20,11,1,0
964,2021,13,Eagles,Jets,33,18,-15,0,1
965,2017,14,Saints,Falcons,17,20,3,1,0
966,2020,14,Texans,Bears,7,36,29,1,0
967,2020,14,Cowboys,Bengals,30,7,-23,0,1
968,2020,14,Chiefs,Dolphins,33,27,-6,0,1
969,2021,13,Colts,Texans,31,0,-31,0,1
970,2021,13,Washington,Raiders,17,15,-2,0,1
971,2021,13,Jaguars,Rams,7,37,30,1,0
972,2017,14,Colts,Bills,7,13,6,1,0
973,2017,14,Bears,Bengals,33,7,-26,0,1
974,2017,14,Packers,Browns,27,21,-6,0,1
975,2017,14,Raiders,Chiefs,15,26,11,1,0
976,2020,14,Cardinals,Giants,26,7,-19,0,1
977,2020,14,Vikings,Buccaneers,14,26,12,1,0
978,2020,14,Broncos,Panthers,32,27,-5,0,1
979,2021,13,Ravens,Steelers,19,20,1,1,0
980,2021,13,49ers,Seahawks,23,30,7,1,0
981,2021,13,Broncos,Chiefs,9,22,13,1,0
982,2021,13,Patriots,Bills,14,10,-4,0,1
983,2017,14,Cowboys,Giants,30,10,-20,0,1
984,2017,14,Lions,Buccaneers,24,21,-3,0,1
985,2017,14,Vikings,Panthers,24,31,7,1,0
986,2020,14,Titans,Jaguars,31,10,-21,0,1
987,2020,14,Colts,Raiders,44,27,-17,0,1
988,2020,14,Jets,Seahawks,3,40,37,1,0
989,2017,14,49ers,Texans,26,16,-10,0,1
990,2017,14,Jets,Broncos,0,23,23,1,0
991,2017,14,Titans,Cardinals,7,12,5,1,0
992,2020,14,Packers,Lions,31,24,-7,0,1
993,2020,14,Saints,Eagles,21,24,3,1,0
994,2020,14,Falcons,Chargers,17,20,3,1,0
995,2017,14,Washington,Chargers,13,30,17,1,0
996,2017,14,Eagles,Rams,43,35,-8,0,1
997,2017,14,Seahawks,Jaguars,24,30,6,1,0
998,2020,14,Washington,49ers,23,15,-8,0,1
999,2020,14,Steelers,Bills,15,26,11,1,0
1000,2020,14,Ravens,Browns,47,42,-5,0,1
1001,2017,14,Ravens,Steelers,38,39,1,1,0
1002,2017,14,Patriots,Dolphins,20,27,7,1,0
1003,2019,14,Cowboys,Bears,24,31,7,1,0
1004,2019,14,Panthers,Falcons,20,40,20,1,0
1005,2019,14,Ravens,Bills,24,17,-7,0,1
1006,2019,14,Bengals,Browns,19,27,8,1,0
1007,2019,14,Washington,Packers,15,20,5,1,0
1008,2019,14,Lions,Vikings,7,20,13,1,0
1009,2019,14,49ers,Saints,48,46,-2,0,1
1010,2019,14,Dolphins,Jets,21,22,1,1,0
1011,2019,14,Colts,Buccaneers,35,38,3,1,0
1012,2019,14,Broncos,Texans,38,24,-14,0,1
1013,2019,14,Chargers,Jaguars,45,10,-35,0,1
1014,2019,14,Titans,Raiders,42,21,-21,0,1
1015,2019,14,Chiefs,Patriots,23,16,-7,0,1
1016,2019,14,Steelers,Cardinals,23,17,-6,0,1
1017,2019,14,Seahawks,Rams,12,28,16,1,0
1018,2019,14,Giants,Eagles,17,23,6,1,0
1019,2019,15,Jets,Ravens,21,42,21,1,0
1020,2020,15,Chargers,Raiders,30,27,-3,0,1
1021,2019,15,Patriots,Bengals,34,13,-21,0,1
1022,2019,15,Buccaneers,Lions,38,17,-21,0,1
1023,2019,15,Bears,Packers,13,21,8,1,0
1024,2020,15,Bills,Broncos,48,19,-29,0,1
1025,2020,15,Panthers,Packers,16,24,8,1,0
1026,2020,15,Buccaneers,Falcons,31,27,-4,0,1
1027,2019,15,Texans,Titans,24,21,-3,0,1
1028,2019,15,Broncos,Chiefs,3,23,20,1,0
1029,2019,15,Dolphins,Giants,20,36,16,1,0
1030,2017,16,Colts,Ravens,16,23,7,1,0
1031,2020,15,49ers,Cowboys,33,41,8,1,0
1032,2020,15,Lions,Titans,25,46,21,1,0
1033,2020,15,Texans,Colts,20,27,7,1,0
1034,2020,15,Patriots,Dolphins,12,22,10,1,0
1035,2019,15,Eagles,Washington,37,27,-10,0,1
1036,2019,15,Seahawks,Panthers,30,24,-6,0,1
1037,2019,15,Jaguars,Raiders,20,16,-4,0,1
1038,2019,15,Browns,Cardinals,24,38,14,1,0
1039,2017,16,Vikings,Packers,16,0,-16,0,1
1040,2017,16,Browns,Bears,3,20,17,1,0
1041,2017,16,Lions,Bengals,17,26,9,1,0
1042,2017,16,Rams,Titans,27,23,-4,0,1
1043,2020,15,Bears,Vikings,33,27,-6,0,1
1044,2020,15,Seahawks,Washington,20,15,-5,0,1
1045,2020,15,Jaguars,Ravens,14,40,26,1,0
1046,2019,15,Vikings,Chargers,39,10,-29,0,1
1047,2019,15,Rams,Cowboys,21,44,23,1,0
1048,2019,15,Falcons,49ers,29,22,-7,0,1
1049,2021,14,Steelers,Vikings,28,36,8,1,0
1050,2017,16,Dolphins,Chiefs,13,29,16,1,0
1051,2017,16,Bills,Patriots,16,37,21,1,0
1052,2017,16,Falcons,Saints,13,23,10,1,0
1053,2020,15,Jets,Rams,23,20,-3,0,1
1054,2020,15,Eagles,Cardinals,26,33,7,1,0
1055,2020,15,Chiefs,Saints,32,29,-3,0,1
1056,2019,15,Bills,Steelers,17,10,-7,0,1
1057,2019,15,Colts,Saints,7,34,27,1,0
1058,2021,14,Ravens,Browns,22,24,2,1,0
1059,2021,14,Jaguars,Titans,0,20,20,1,0
1060,2021,14,Raiders,Chiefs,9,48,39,1,0
1061,2017,15,Broncos,Colts,25,13,-12,0,1
1062,2017,16,Chargers,Jets,14,7,-7,0,1
1063,2017,16,Broncos,Washington,11,27,16,1,0
1064,2017,16,Buccaneers,Panthers,19,22,3,1,0
1065,2018,15,Chargers,Chiefs,29,28,-1,0,1
1066,2020,15,Browns,Giants,20,6,-14,0,1
1067,2020,15,Steelers,Bengals,17,27,10,1,0
1068,2021,14,Saints,Jets,30,9,-21,0,1
1069,2021,14,Cowboys,Washington,27,20,-7,0,1
1070,2021,14,Falcons,Panthers,29,21,-8,0,1
1071,2021,14,Seahawks,Texans,33,13,-20,0,1
1072,2017,15,Bears,Lions,10,20,10,1,0
1073,2017,15,Chargers,Chiefs,13,30,17,1,0
1074,2017,15,Dolphins,Bills,16,24,8,1,0
1075,2017,16,Jaguars,49ers,33,44,11,1,0
1076,2017,16,Seahawks,Cowboys,21,12,-9,0,1
1077,2017,16,Giants,Cardinals,0,23,23,1,0
1078,2018,15,Texans,Jets,29,22,-7,0,1
1079,2018,15,Browns,Broncos,17,16,-1,0,1
1080,2018,15,Cardinals,Falcons,14,40,26,1,0
1081,2021,14,Lions,Broncos,10,38,28,1,0
1082,2021,14,Giants,Chargers,21,37,16,1,0
1083,2021,14,49ers,Bengals,26,23,-3,0,1
1084,2017,15,Ravens,Browns,27,10,-17,0,1
1085,2017,15,Bengals,Vikings,7,34,27,1,0
1086,2017,15,Jets,Saints,19,31,12,1,0
1087,2017,16,Steelers,Texans,34,6,-28,0,1
1088,2017,16,Raiders,Eagles,10,19,9,1,0
1089,2018,15,Lions,Bills,13,14,1,1,0
1090,2018,15,Packers,Bears,17,24,7,1,0
1091,2018,15,Raiders,Bengals,16,30,14,1,0
1092,2021,14,Bills,Buccaneers,27,33,6,1,0
1093,2021,14,Bears,Packers,30,45,15,1,0
1094,2021,14,Rams,Cardinals,30,23,-7,0,1
1095,2017,15,Eagles,Giants,34,29,-5,0,1
1096,2017,15,Cardinals,Washington,15,20,5,1,0
1097,2017,15,Packers,Panthers,24,31,7,1,0
1098,2018,15,Cowboys,Colts,0,23,23,1,0
1099,2018,15,Dolphins,Vikings,17,41,24,1,0
1100,2018,15,Titans,Giants,17,0,-17,0,1
1101,2017,15,Texans,Jaguars,7,45,38,1,0
1102,2017,15,Rams,Seahawks,42,7,-35,0,1
1103,2017,15,Patriots,Steelers,27,24,-3,0,1
1104,2018,15,Washington,Jaguars,16,13,-3,0,1
1105,2018,15,Buccaneers,Ravens,12,20,8,1,0
1106,2018,15,Seahawks,49ers,23,26,3,1,0
1107,2021,15,Chiefs,Chargers,34,28,-6,0,1
1108,2017,15,Titans,49ers,23,25,2,1,0
1109,2017,15,Cowboys,Raiders,20,17,-3,0,1
1110,2017,15,Falcons,Buccaneers,24,21,-3,0,1
1111,2018,15,Patriots,Steelers,10,17,7,1,0
1112,2018,15,Eagles,Rams,30,23,-7,0,1
1113,2018,15,Saints,Panthers,12,9,-3,0,1
1114,2021,15,Patriots,Colts,17,27,10,1,0
1115,2021,15,Panthers,Bills,14,31,17,1,0
1116,2021,15,Cardinals,Lions,12,30,18,1,0
1117,2020,16,Vikings,Saints,33,52,19,1,0
1118,2021,15,Jets,Dolphins,24,31,7,1,0
1119,2021,15,Cowboys,Giants,21,6,-15,0,1
1120,2021,15,Titans,Steelers,13,19,6,1,0
1121,2020,16,Buccaneers,Lions,47,7,-40,0,1
1122,2020,16,49ers,Cardinals,20,12,-8,0,1
1123,2020,16,Dolphins,Raiders,26,25,-1,0,1
1124,2021,15,Texans,Jaguars,30,16,-14,0,1
1125,2021,15,Bengals,Broncos,15,10,-5,0,1
1126,2021,15,Falcons,49ers,13,31,18,1,0
1127,2020,16,Falcons,Chiefs,14,17,3,1,0
1128,2020,16,Browns,Jets,16,23,7,1,0
1129,2020,16,Colts,Steelers,24,28,4,1,0
1130,2021,15,Packers,Ravens,31,30,-1,0,1
1131,2021,15,Saints,Buccaneers,9,0,-9,0,1
1132,2021,15,Raiders,Browns,16,14,-2,0,1
1133,2020,16,Bears,Jaguars,41,17,-24,0,1
1134,2020,16,Giants,Ravens,13,27,14,1,0
1135,2020,16,Bengals,Texans,37,31,-6,0,1
1136,2021,15,Vikings,Bears,17,9,-8,0,1
1137,2021,15,Seahawks,Rams,10,20,10,1,0
1138,2021,15,Washington,Eagles,17,27,10,1,0
1139,2020,16,Broncos,Chargers,16,19,3,1,0
1140,2020,16,Panthers,Washington,20,13,-7,0,1
1141,2020,16,Eagles,Cowboys,17,37,20,1,0
1142,2020,16,Rams,Seahawks,9,20,11,1,0
1143,2020,16,Titans,Packers,14,40,26,1,0
1144,2020,16,Bills,Patriots,38,9,-29,0,1
1145,2018,17,Dolphins,Bills,17,42,25,1,0
1146,2018,17,Lions,Packers,31,0,-31,0,1
1147,2018,17,Jets,Patriots,3,38,35,1,0
1148,2018,17,Panthers,Saints,33,14,-19,0,1
1149,2018,17,Cowboys,Giants,36,35,-1,0,1
1150,2018,17,Falcons,Buccaneers,34,32,-2,0,1
1151,2018,17,Jaguars,Texans,3,20,17,1,0
1152,2018,17,Chargers,Broncos,23,9,-14,0,1
1153,2018,17,Raiders,Chiefs,3,35,32,1,0
1154,2018,17,49ers,Rams,32,48,16,1,0
1155,2018,17,Bears,Vikings,24,10,-14,0,1
1156,2018,17,Bengals,Steelers,13,16,3,1,0
1157,2018,17,Cardinals,Seahawks,24,27,3,1,0
1158,2018,16,Washington,Titans,16,25,9,1,0
1159,2018,17,Eagles,Washington,24,0,-24,0,1
1160,2018,17,Browns,Ravens,24,26,2,1,0
1161,2018,17,Colts,Titans,33,17,-16,0,1
1162,2018,16,Ravens,Chargers,22,10,-12,0,1
1163,2018,16,Bengals,Browns,18,26,8,1,0
1164,2018,16,Buccaneers,Cowboys,20,27,7,1,0
1165,2018,16,Vikings,Lions,27,9,-18,0,1
1166,2018,16,Giants,Colts,27,28,1,1,0
1167,2018,16,Jaguars,Dolphins,17,7,-10,0,1
1168,2018,16,Bills,Patriots,12,24,12,1,0
1169,2018,16,Packers,Jets,44,38,-6,0,1
1170,2018,16,Texans,Eagles,30,32,2,1,0
1171,2018,16,Falcons,Panthers,24,10,-14,0,1
1172,2018,16,Rams,Cardinals,31,9,-22,0,1
1173,2018,16,Bears,49ers,14,9,-5,0,1
1174,2018,16,Steelers,Saints,28,31,3,1,0
1175,2018,16,Chiefs,Seahawks,31,38,7,1,0
1176,2018,16,Broncos,Raiders,14,27,13,1,0
1177,2019,16,Texans,Buccaneers,23,20,-3,0,1
1178,2021,16,49ers,Titans,17,20,3,1,0
1179,2019,16,Bills,Patriots,17,24,7,1,0
1180,2019,16,Rams,49ers,31,34,3,1,0
1181,2019,16,Jaguars,Falcons,12,24,12,1,0
1182,2019,16,Ravens,Browns,31,15,-16,0,1
1183,2021,16,Browns,Packers,22,24,2,1,0
1184,2021,16,Colts,Cardinals,22,16,-6,0,1
1185,2021,16,Lions,Falcons,16,20,4,1,0
1186,2019,16,Saints,Titans,38,28,-10,0,1
1187,2019,16,Panthers,Colts,6,38,32,1,0
1188,2019,16,Bengals,Dolphins,35,38,3,1,0
1189,2021,16,Ravens,Bengals,21,41,20,1,0
1190,2021,16,Rams,Vikings,30,23,-7,0,1
1191,2021,16,Bills,Patriots,33,21,-12,0,1
1192,2019,16,Steelers,Jets,10,16,6,1,0
1193,2019,16,Giants,Washington,41,35,-6,0,1
1194,2019,16,Lions,Broncos,17,27,10,1,0
1195,2021,16,Jaguars,Jets,21,26,5,1,0
1196,2021,16,Giants,Eagles,10,34,24,1,0
1197,2021,16,Buccaneers,Panthers,32,6,-26,0,1
1198,2019,16,Raiders,Chargers,24,17,-7,0,1
1199,2019,16,Cowboys,Eagles,9,17,8,1,0
1200,2019,16,Cardinals,Seahawks,27,13,-14,0,1
1201,2017,17,Packers,Lions,11,35,24,1,0
1202,2021,16,Chargers,Texans,29,41,12,1,0
1203,2021,16,Bears,Seahawks,25,24,-1,0,1
1204,2021,16,Steelers,Chiefs,10,36,26,1,0
1205,2019,16,Chiefs,Bears,26,3,-23,0,1
1206,2019,16,Packers,Vikings,23,10,-13,0,1
1207,2017,17,Texans,Colts,13,22,9,1,0
1208,2017,17,Bears,Vikings,10,23,13,1,0
1209,2017,17,Jets,Patriots,6,26,20,1,0
1210,2021,16,Broncos,Raiders,13,17,4,1,0
1211,2021,16,Washington,Cowboys,14,56,42,1,0
1212,2021,16,Dolphins,Saints,20,3,-17,0,1
1213,2017,17,Washington,Giants,10,18,8,1,0
1214,2017,17,Cowboys,Eagles,6,0,-6,0,1
1215,2017,17,Browns,Steelers,24,28,4,1,0
1216,2017,17,Panthers,Falcons,10,22,12,1,0
1217,2017,17,Chiefs,Broncos,27,24,-3,0,1
1218,2017,17,Jaguars,Titans,10,15,5,1,0
1219,2019,17,Jets,Bills,13,6,-7,0,1
1220,2017,17,49ers,Rams,34,13,-21,0,1
1221,2017,17,Bills,Dolphins,22,16,-6,0,1
1222,2017,17,Raiders,Chargers,10,30,20,1,0
1223,2019,17,Browns,Bengals,23,33,10,1,0
1224,2019,17,Packers,Lions,23,20,-3,0,1
1225,2019,17,Chargers,Chiefs,21,31,10,1,0
1226,2017,17,Cardinals,Seahawks,26,24,-2,0,1
1227,2017,17,Saints,Buccaneers,24,31,7,1,0
1228,2017,17,Bengals,Ravens,31,27,-4,0,1
1229,2019,17,Bears,Vikings,21,19,-2,0,1
1230,2019,17,Dolphins,Patriots,27,24,-3,0,1
1231,2019,17,Falcons,Buccaneers,28,22,-6,0,1
1232,2019,17,Saints,Panthers,42,10,-32,0,1
1233,2019,17,Washington,Cowboys,16,47,31,1,0
1234,2019,17,Raiders,Broncos,15,16,1,1,0
1235,2019,17,Cardinals,Rams,24,31,7,1,0
1236,2019,17,Eagles,Giants,34,17,-17,0,1
1237,2019,17,Colts,Jaguars,20,38,18,1,0
1238,2019,17,Steelers,Ravens,10,28,18,1,0
1239,2019,17,Titans,Texans,35,14,-21,0,1
1240,2019,17,49ers,Seahawks,26,21,-5,0,1
1241,2020,17,Dolphins,Bills,26,56,30,1,0
1242,2020,17,Ravens,Bengals,38,3,-35,0,1
1243,2020,17,Steelers,Browns,22,24,2,1,0
1244,2020,17,Vikings,Lions,37,35,-2,0,1
1245,2020,17,Jets,Patriots,14,28,14,1,0
1246,2020,17,Cowboys,Giants,19,23,4,1,0
1247,2020,17,Falcons,Buccaneers,27,44,17,1,0
1248,2020,17,Packers,Bears,35,16,-19,0,1
1249,2020,17,Raiders,Broncos,32,31,-1,0,1
1250,2020,17,Jaguars,Colts,14,28,14,1,0
1251,2020,17,Chargers,Chiefs,38,21,-17,0,1
1252,2020,17,Cardinals,Rams,7,18,11,1,0
1253,2020,17,Seahawks,49ers,26,23,-3,0,1
1254,2021,17,Falcons,Bills,15,29,14,1,0
1255,2020,17,Saints,Panthers,33,7,-26,0,1
1256,2020,17,Titans,Texans,41,38,-3,0,1
1257,2020,17,Washington,Eagles,20,14,-6,0,1
1258,2021,17,Giants,Bears,3,29,26,1,0
1259,2021,17,Chiefs,Bengals,31,34,3,1,0
1260,2021,17,Dolphins,Titans,3,34,31,1,0
1261,2021,17,Raiders,Colts,23,20,-3,0,1
1262,2021,17,Jaguars,Patriots,10,50,40,1,0
1263,2021,17,Buccaneers,Jets,28,24,-4,0,1
1264,2021,17,Eagles,Washington,20,16,-4,0,1
1265,2021,17,Rams,Ravens,20,19,-1,0,1
1266,2021,17,Broncos,Chargers,13,34,21,1,0
1267,2021,17,Texans,49ers,7,23,16,1,0
1268,2021,17,Cardinals,Cowboys,25,22,-3,0,1
1269,2021,17,Panthers,Saints,10,18,8,1,0
1270,2021,17,Lions,Seahawks,29,51,22,1,0
1271,2021,17,Vikings,Packers,10,37,27,1,0
1272,2021,17,Browns,Steelers,14,26,12,1,0
1273,2021,18,Chiefs,Broncos,28,24,-4,0,1
1274,2021,18,Cowboys,Eagles,51,26,-25,0,1
1275,2021,18,Bengals,Browns,16,21,5,1,0
1276,2021,18,Packers,Lions,30,37,7,1,0
1277,2021,18,Bears,Vikings,17,31,14,1,0
1278,2021,18,Washington,Giants,22,7,-15,0,1
1279,2021,18,Colts,Jaguars,11,26,15,1,0
1280,2021,18,Steelers,Ravens,16,13,-3,0,1
1281,2021,18,Titans,Texans,28,25,-3,0,1
1282,2021,18,Saints,Falcons,30,20,-10,0,1
1283,2021,18,Jets,Bills,10,27,17,1,0
1284,2021,18,49ers,Rams,27,24,-3,0,1
1285,2021,18,Patriots,Dolphins,24,33,9,1,0
1286,2021,18,Seahawks,Cardinals,38,30,-8,0,1
1287,2021,18,Panthers,Buccaneers,17,41,24,1,0
1288,2021,18,Chargers,Raiders,32,35,3,1,0
